 ██████████████████████████████████
 █                                █
 ██████████████████████████████████
 █                               ░█
 █                                █
 █ ☺                              █
 ██████████████████████████████████
 █                                █
 █                                █
 █                                █
 █                                █
 █                                █
 █                                █
 █                                █
 ██████████████████████████████████