 ██████████████████████████████████
 █   ▁█      █        █֍       █ ۞█
 ██ ███ ██████        ████████ █  █
 █           █        █▁       ██ █
 ███████████ █        ███████████ █
 █ ⌂         █        █████████֍  █
 ██████████████████████████████████
 █           █░      ░█           █
 █           █░  ֎   ░█           █
 ██████████████████████████████████
 █۞ █   ██████                    █
 █    █ ██████                    █
 ██████ ███ ֎█                    █
 ██████      █                    █
 ██████████████████████████████████