 ██████████████████████████████████
 █▒▒▒▒▒▒▒▒▒▒▒▒▒▒█▒▒▒▒▒▒▒▒▒▒▒▒▒▒▒▒▒█
 █              █    ████        ▒█
 █ ████         █                ▒█
 █      ██      █░               ▒█
 █ ⌂        ██████████           ▒█
 ███   █      ▒   ▒              ▒█
 █       ███                ▒    ▒█
 █    ▒     ██████████     ▒█▒   ▒█
 █   ▒█▒        █       ▒   ▒    ▒█
 █    ▒         █      ▒█▒       ▒█
 █              █       ▒        ▒█
 █              █                ▒█
 █▒▒▒▒▒▒▒▒▒▒▒▒▒▒█▒▒▒▒▒▒▒▒▒▒▒▒▒▒▒▒▒█
 ██████████████████████████████████