 ██████████████████████████████████
 █▒▒▒▒▒▒▒▒▒▒▒▒▒▒▒▒▒▒▒▒▒▒▒▒▒▒▒▒▒▒▒▒█
 █   ████ ▒ █████ ▒ ████ ▒       ▒█
 █                               ▒█
 █                               ▒█
 █ ⌂   ▒     ▒        ▒          ▒█
 █████████████  ███████  ██████████
 █▒▒▒▒▒▒▒▒▒▒▒▒▒▒▒▒▒▒▒▒█  █▒▒▒▒▒▒▒▒█
 █░   ███ ████        █  █       ▒█
 █                    █  █       ▒█
 █                               ▒█
 █                               ▒█
 █ ███  ██   ███████████         ▒█
 █▒▒▒▒▒▒▒▒▒▒▒▒▒▒▒▒▒▒▒▒▒▒▒▒▒▒▒▒▒▒▒▒█
 ██████████████████████████████████