 ██████████████████████████████████
 █▒▒▒▒▒▒▒▒▒▒▒▒▒▒█▒▒▒▒▒▒▒▒▒▒▒▒▒▒▒▒▒█
 █              █  ████          ▒█
 █ ████▒        █                ▒█
 █      ██▒▒    █░ ▒             ▒█
 █ ⌂        ██████████           ▒█
 ███   █      ▒   ▒              ▒█
 █       ███    ▒   ▒       ▒    ▒█
 █    ▒     ▒█████████     ▒█▒   ▒█
 █   ▒█▒        █       ▒   ▒    ▒█
 █    ▒         █      ▒█▒       ▒█
 █              █       ▒        ▒█
 █              █                ▒█
 █▒▒▒▒▒▒▒▒▒▒▒▒▒▒█▒▒▒▒▒▒▒▒▒▒▒▒▒▒▒▒▒█
 ██████████████████████████████████