 ██████████████████████████████████
 █▒▒▒▒▒▒▒▒▒▒▒▒▒▒▒▒▒▒▒▒▒▒▒▒▒▒▒▒▒▒▒▒█
 █        ████      ████         ▒█
 █                             ░ ▒█
 █                               ▒█
 █ ⌂                             ▒█
 ███                             ▒█
 █▒                              ▒█
 █▒                              ▒█
 █▒                              ▒█
 █▒                              ▒█
 █▒                              ▒█
 █▒  ████      ████      ████    ▒█
 █▒▒▒▒▒▒▒▒▒▒▒▒▒▒▒▒▒▒▒▒▒▒▒▒▒▒▒▒▒▒▒▒█
 ██████████████████████████████████