 ██████████████████████████████████
 █▒▒▒▒▒▒▒▒▒▒▒▒▒▒▒▒▒▒▒▒▒▒▒▒▒▒▒▒▒▒▒▒█
 █                               ▒█
 █           ██████████████████  ▒█
 █                           ▒█  ▒█
 █ ⌂                         ▒█  ▒█
 ███            █▒▒▒▒▒▒▒▒▒▒  ▒█  ▒█
 █▒██████████   ██████████▒  ▒█  ▒█
 █▒                      █▒  ▒█  ▒█
 █▒▒▒▒▒▒▒▒▒▒▒▒▒▒▒▒▒▒▒▒▒▒▒█▒  ▒█  ▒█
 █████████████████████████▒  ▒█████
 █   ▒     ▒     ▒▒▒▒▒▒▒▒▒▒  ▒▒▒▒▒█
 █   ▒  ▒  ▒  ▒  ▒                █
 █ ░    ▒     ▒                   █
 ██████████████████████████████████