 █████████████████████████████████
 █▒▒▒▒▒█▒▒▒▒▒▒██████████▒▒▒▒▒▒▒▒▒▒█
 █     █     ██                  ▒█
 █     █                     ▒   ▒█
 █     █      █             ▒█▒  ▒█
 █ ⌂   █      █      ▒       ▒   ▒█
 ███   █   ▒  █     ▒█▒          ▒█
 █     █  ▒█▒ █      ▒  ██████ ████
 █     █   ▒  █  ▒      █        ▒█
 █     █      █ ▒█▒     █  ▒     ▒█
 █     ██████ █  ▒      █ ▒█▒    ▒█
 █            █         █  ▒     ██
 █    ██      █         █       ░██
 █▒▒▒▒▒█▒▒▒▒▒▒█▒▒▒▒▒▒▒▒▒█▒▒▒▒▒▒████
 ██████████████████████████████████